# # # # # # # # # # # # # # # # # # # # # # #
# # # #         # # # # # # #         # # # #
# #   - - - - - -   #X^ #   - - - - - -   # #
# # - - ~ ~ ~ ~ - -       - - ~ ~ ~ ~ - - # #
#   - ~ ~ ~ ~ ~ ~ -       - ~ ~ ~ ~ ~ ~ -   #
#   - ~ ~ ~ ~ ~ ~ -       - ~ ~ ~ ~ ~ ~ -   #
# # - - ~ ~ ~ ~ - -       - - ~ ~ ~ ~ - - # #
# #   - - - - - -   #Nv #   - - - - - -   # #
# # # #         # # # # # # #         # # # #
# # # # # # # # # # # # # # # # # # # # # # #