# # # # # # # # # # # # #
# # - - - - - - - - - # #
# - - -           - - - #
#                       #
#                       #
#                       #
# #                   # #
# # # # # #Nv # # # # # #
# # # # # # # # # # # # #